R         1920    1080    
NO ./textures/redbrick.xpm
SO ./textures/purplestone.xpm
WE ./textures/bluestone.xpm
EA ./textures/greystone.xpm
S ./textures/barrel.xpm
F 229,111,200
C 244,020,50

11111
10001
10001
10N01
11111