R         1920    1080    
NO        ./path_to_the_north_texture
SO ./path_to_the_south_texture
WE ./path_to_the_west_texture
EA ./path_to_the_east_texture
S ./path_to_the_sprite_texture
F 2,0,0
C 244,020,50


1111111
1100011
11SW011
1111001
1111101